10 10
M###Y####M
##O####O##
##-##Y#-##
R########R
#-######-#
##------##
##########
##########
#P######G#
C###PG###C
