6 10
C########C
##########
#BPR####G#
Y##O##O##Y
#B####PRG#
M########M