10 10
##G#######
##R#######
##########
###--##M##
###G-##C##
###--#####
##########
######-###
C#########
#M#####R##